#####
###u#
#####
#P..#
#####
