#######
#######
#u#u#.#
#####.#
#P....#
#######
#######
