##########
##########
######.###
####.#.###
##u#.#.###
####o#.###
######.###
######P###
##########
##########
