##########
##########
######.###
####.#.###
####.#.###
##u#o#.###
######.###
######P###
##########
##########
