#########
###..P###
###...###
###...###
#########
###o#o###
###...###
####.####
#########
