##########
#....#####
#..#######
#..#.#####
#..#.#####
#.P#.##.##
#..#oo.o##
#####.#.##
#####.####
##########
