########
########
###...##
###z..##
###...##
#P.o..##
########
########
