#######
#######
####..#
###z..#
###o..#
#P...##
#######
