########
#.P#####
##.#..##
#..#.###
#..#..##
##.#.###
####i.##
########
