############
############
##{#######}#
############
############
#.P.##ooo#]#
############
############
############
##[]########
############
############
