############
######s#####
######..i###
###.###o..}#
###..#######
#..P..####]#
###.########
###.########
############