############
######s#####
######..i###
###.###o..}#
###..#######
#..P..######
###.######]#
###.########
############