#####
#oi.#
#oi.#
#..##
##.##
#.P.#
#####
