#####
#o.i#
#o.i#
#..##
##.##
#.P.#
#####
