#P#.#
#u#.#
#i#.#
#o#.#
#s###
